id,Geographic Area Name,Estimate!!Total!!Population 18 to 24 years,Estimate!!Total!!Population 18 to 24 years!!Less than high school graduate,Estimate!!Total!!Population 18 to 24 years!!High school graduate (includes equivalency),Estimate!!Total!!Population 18 to 24 years!!Some college or associate's degree,Estimate!!Total!!Population 18 to 24 years!!Bachelor's degree or higher,Estimate!!Total!!Population 25 years and over,Estimate!!Total!!Population 25 years and over!!Less than 9th grade,Estimate!!Total!!Population 25 years and over!!9th to 12th grade!!no diploma,Estimate!!Total!!Population 25 years and over!!High school graduate (includes equivalency),Estimate!!Total!!Population 25 years and over!!Some college!!no degree,Estimate!!Total!!Population 25 years and over!!Associate's degree,Estimate!!Total!!Population 25 years and over!!Bachelor's degree,Estimate!!Total!!Population 25 years and over!!Graduate or professional degree,Estimate!!Total!!Population 25 years and over!!High school graduate or higher,Estimate!!Total!!Population 25 years and over!!Bachelor's degree or higher
0500000US48001,Anderson County  Texas,4639,1116,2216,1202,105,42009,2707,5644,15224,10696,2807,3189,1742,33658,4931
0500000US48003,Andrews County  Texas,1689,236,923,491,39,10610,1431,1264,3898,2161,753,705,398,7915,1103
0500000US48005,Angelina County  Texas,7671,783,3041,3552,295,57243,5085,5741,18265,14230,4578,6455,2889,46417,9344
0500000US48007,Aransas County  Texas,1908,943,538,402,25,18136,943,1799,5392,4764,1302,2391,1545,15394,3936
0500000US48009,Archer County  Texas,696,99,257,258,82,6181,224,334,2057,1655,462,1045,404,5623,1449
0500000US48011,Armstrong County  Texas,107,1,73,29,4,1413,62,102,345,431,145,228,100,1249,328
0500000US48013,Atascosa County  Texas,4350,819,1913,1478,140,30916,3505,3527,12335,5923,1516,2875,1235,23884,4110
0500000US48015,Austin County  Texas,2326,339,1061,800,126,20134,1699,1703,5906,4585,1501,3378,1362,16732,4740
0500000US48017,Bailey County  Texas,661,223,371,67,0,4407,579,563,1553,731,201,621,159,3265,780
0500000US48019,Bandera County  Texas,1326,218,648,416,44,16678,564,1217,5301,4194,1432,2662,1308,14897,3970
0500000US48021,Bastrop County  Texas,7053,1664,2814,2320,255,54428,5345,4989,15984,13696,3331,7622,3461,44094,11083
0500000US48023,Baylor County  Texas,262,14,101,133,14,2529,98,192,822,688,231,383,115,2239,498
0500000US48025,Bee County  Texas,3501,777,1426,1255,43,22241,2432,3419,7751,4982,1398,1376,883,16390,2259
0500000US48027,Bell County  Texas,40283,4442,15757,17458,2626,206845,8130,11374,53563,60328,22680,33194,17576,187341,50770
0500000US48029,Bexar County  Texas,202571,26762,69702,90302,15805,1224170,92133,105737,308714,281560,98278,214830,122918,1026300,337748
0500000US48031,Blanco County  Texas,759,63,336,246,114,8463,345,446,2433,2181,761,1411,886,7672,2297
0500000US48033,Borden County  Texas,30,7,9,14,0,463,2,30,121,117,31,107,55,431,162
0500000US48035,Bosque County  Texas,1233,231,382,581,39,12989,740,1201,4638,2985,1022,1676,727,11048,2403
0500000US48037,Bowie County  Texas,8107,1062,3942,2939,164,63489,2340,5175,22063,16697,4588,8599,4027,55974,12626
0500000US48039,Brazoria County  Texas,29270,3927,9578,13433,2332,230216,12831,15474,58155,56232,19085,43898,24541,201911,68439
0500000US48041,Brazos County  Texas,58737,2235,8847,40433,7222,115287,7633,7755,22639,22280,7901,25082,21997,99899,47079
0500000US48043,Brewster County  Texas,702,114,263,236,89,6732,412,580,1370,1499,219,1696,956,5740,2652
0500000US48045,Briscoe County  Texas,159,0,66,69,24,1096,67,81,366,275,58,182,67,948,249
0500000US48047,Brooks County  Texas,1192,304,420,468,0,4143,627,613,1139,956,77,479,252,2903,731
0500000US48049,Brown County  Texas,3489,493,1227,1521,248,25722,1533,2031,9180,6090,1916,3618,1354,22158,4972
0500000US48051,Burleson County  Texas,1467,326,658,326,157,12396,762,1406,4864,2557,687,1480,640,10228,2120
0500000US48053,Burnet County  Texas,3781,693,1679,1180,229,32115,1550,2263,9992,7764,2474,5482,2590,28302,8072
0500000US48055,Caldwell County  Texas,4816,1208,2346,1091,171,26495,2586,3041,9883,5621,1450,2657,1257,20868,3914
0500000US48057,Calhoun County  Texas,1886,502,985,351,48,14475,1287,1501,4819,3547,1152,1463,706,11687,2169
0500000US48059,Callahan County  Texas,912,87,414,383,28,9637,365,774,3659,2410,590,1367,472,8498,1839
0500000US48061,Cameron County  Texas,45151,8938,17450,17277,1486,245532,48015,32550,63733,41565,17258,29858,12553,164967,42411
0500000US48063,Camp County  Texas,1069,129,526,353,61,8345,593,697,2981,1957,567,1096,454,7055,1550
0500000US48065,Carson County  Texas,459,78,178,184,19,4032,67,191,1160,955,434,761,464,3774,1225
0500000US48067,Cass County  Texas,2136,436,707,928,65,21139,740,2327,9155,3931,1527,2340,1119,18072,3459
0500000US48069,Castro County  Texas,791,299,249,230,13,4717,831,403,1518,1067,198,434,266,3483,700
0500000US48071,Chambers County  Texas,3443,444,1374,1457,168,25562,1486,1764,7445,7268,2110,3739,1750,22312,5489
0500000US48073,Cherokee County  Texas,4860,1216,1648,1720,276,33820,3125,3864,10640,8001,2482,3780,1928,26831,5708
0500000US48075,Childress County  Texas,920,243,474,189,14,4958,279,518,1929,1073,301,682,176,4161,858
0500000US48077,Clay County  Texas,740,134,239,330,37,7494,287,416,2958,1822,618,1005,388,6791,1393
0500000US48079,Cochran County  Texas,215,87,78,50,0,1868,395,208,577,419,115,106,48,1265,154
0500000US48081,Coke County  Texas,129,25,16,63,25,2467,173,223,867,604,178,263,159,2071,422
0500000US48083,Coleman County  Texas,421,127,131,125,38,6141,416,699,2094,1601,374,638,319,5026,957
0500000US48085,Collin County  Texas,76626,10042,23283,30758,12543,616730,20816,18315,91405,121199,45997,203802,115196,577599,318998
0500000US48087,Collingsworth County  Texas,267,66,143,51,7,2003,224,255,613,420,122,277,92,1524,369
0500000US48089,Colorado County  Texas,1792,348,641,680,123,14336,1313,1338,5218,2662,1132,1956,717,11685,2673
0500000US48091,Comal County  Texas,10288,1388,4269,3628,1003,93869,3230,3872,24400,22381,6869,21678,11439,86767,33117
0500000US48093,Comanche County  Texas,1032,290,305,385,52,9440,1018,512,3419,2086,539,1346,520,7910,1866
0500000US48095,Concho County  Texas,702,204,441,34,23,2990,710,423,841,579,80,244,113,1857,357
0500000US48097,Cooke County  Texas,3433,465,1144,1618,206,26634,1416,2267,8382,6922,2176,3748,1723,22951,5471
0500000US48099,Coryell County  Texas,10323,815,5202,3932,374,47257,2266,3343,13217,15831,5198,5339,2063,41648,7402
0500000US48101,Cottle County  Texas,43,14,7,22,0,1033,84,138,340,265,48,105,53,811,158
0500000US48103,Crane County  Texas,447,131,197,119,0,2886,359,309,885,730,244,261,98,2218,359
0500000US48105,Crockett County  Texas,250,19,150,81,0,2399,90,418,822,552,179,253,85,1891,338
0500000US48107,Crosby County  Texas,517,117,128,267,5,3753,407,488,1348,822,208,370,110,2858,480
0500000US48109,Culberson County  Texas,124,16,52,51,5,1581,328,189,598,251,73,113,29,1064,142
0500000US48111,Dallam County  Texas,583,147,358,45,33,4379,680,668,1161,1156,117,448,149,3031,597
0500000US48113,Dallas County  Texas,250073,42130,81918,97218,28807,1648710,187087,164354,372587,323718,94410,322294,184260,1297269,506554
0500000US48115,Dawson County  Texas,1523,617,542,354,10,8277,1063,1193,3029,1660,295,793,244,6021,1037
0500000US48117,Deaf Smith County  Texas,1863,331,622,891,19,11100,1809,1185,3797,2324,635,1008,342,8106,1350
0500000US48119,Delta County  Texas,430,98,115,217,0,3565,169,344,1208,841,244,482,277,3052,759
0500000US48121,Denton County  Texas,75786,8181,19658,39692,8255,526185,18773,20837,95181,117536,39855,157893,76110,486575,234003
0500000US48123,DeWitt County  Texas,1258,257,527,438,36,14552,1224,1543,5705,3328,890,1340,522,11785,1862
0500000US48125,Dickens County  Texas,133,45,36,38,14,1603,74,222,548,402,90,160,107,1307,267
0500000US48127,Dimmit County  Texas,934,503,222,209,0,6534,1640,497,2170,1042,261,667,257,4397,924
0500000US48129,Donley County  Texas,444,24,118,300,2,2257,99,167,720,676,149,317,129,1991,446
0500000US48131,Duval County  Texas,1139,284,495,360,0,7254,1170,1216,2254,1511,431,407,265,4868,672
0500000US48133,Eastland County  Texas,1976,312,535,1030,99,12553,673,1380,4451,3377,999,1008,665,10500,1673
0500000US48135,Ector County  Texas,17020,3493,6317,6274,936,93728,8501,13941,28230,22505,5947,10624,3980,71286,14604
0500000US48137,Edwards County  Texas,213,75,118,20,0,1495,270,93,434,245,142,278,33,1132,311
0500000US48139,Ellis County  Texas,15254,2551,4833,7019,851,108071,7076,8419,30531,28112,8937,17562,7434,92576,24996
0500000US48141,El Paso County  Texas,96782,11817,29128,50384,5453,508397,69362,44914,121278,117636,39463,78024,37720,394121,115744
0500000US48143,Erath County  Texas,9079,490,1890,6272,427,23659,1390,1899,5548,6259,1536,4630,2397,20370,7027
0500000US48145,Falls County  Texas,1587,397,629,509,52,12035,1124,1639,4562,2343,814,1252,301,9272,1553
0500000US48147,Fannin County  Texas,2879,734,982,1083,80,24052,1209,2406,8622,6154,1635,2635,1391,20437,4026
0500000US48149,Fayette County  Texas,1834,237,837,703,57,18026,1634,1212,7265,3494,1159,2431,831,15180,3262
0500000US48151,Fisher County  Texas,358,44,129,143,42,2718,212,171,932,638,270,391,104,2335,495
0500000US48153,Floyd County  Texas,470,71,225,163,11,3823,577,437,1067,855,278,465,144,2809,609
0500000US48155,Foard County  Texas,99,18,2,79,0,1047,95,141,300,248,93,134,36,811,170
0500000US48157,Fort Bend County  Texas,61660,8725,17928,28404,6603,472198,23301,22913,83705,91474,32898,133723,84184,425984,217907
0500000US48159,Franklin County  Texas,816,102,349,322,43,7260,475,345,2175,2103,447,1265,450,6440,1715
0500000US48161,Freestone County  Texas,1309,260,452,431,166,13854,957,1514,4549,3550,1477,1342,465,11383,1807
0500000US48163,Frio County  Texas,2687,902,1274,422,89,12088,2141,1894,4319,2031,838,656,209,8053,865
0500000US48165,Gaines County  Texas,1895,514,938,359,84,11142,3109,1217,3272,1581,584,1012,367,6816,1379
0500000US48167,Galveston County  Texas,28203,4517,8504,12116,3066,218621,9788,15982,55710,51489,19960,43315,22377,192851,65692
0500000US48169,Garza County  Texas,640,188,328,124,0,4597,1077,699,1281,797,104,454,185,2821,639
0500000US48171,Gillespie County  Texas,1747,271,766,589,121,19255,1029,1018,5896,3814,990,4780,1728,17208,6508
0500000US48173,Glasscock County  Texas,216,22,56,91,47,876,184,69,183,168,69,140,63,623,203
0500000US48175,Goliad County  Texas,658,157,214,269,18,5257,415,235,1614,1560,508,645,280,4607,925
0500000US48177,Gonzales County  Texas,1791,417,912,434,28,13288,1603,1597,5503,2347,602,1197,439,10088,1636
0500000US48179,Gray County  Texas,1756,360,686,645,65,15109,1134,1873,4883,3949,1254,1541,475,12102,2016
0500000US48181,Grayson County  Texas,11093,1496,3844,5301,452,86890,3435,6501,26822,23892,8450,12152,5638,76954,17790
0500000US48183,Gregg County  Texas,11924,1513,4053,5746,612,79588,5033,7836,22830,21138,6229,11393,5129,66719,16522
0500000US48185,Grimes County  Texas,2437,725,1028,641,43,18973,1547,2325,6745,4641,942,1734,1039,15101,2773
0500000US48187,Guadalupe County  Texas,13986,1994,6385,4717,890,101274,4582,6917,31336,21731,8817,17930,9961,89775,27891
0500000US48189,Hale County  Texas,3862,789,1526,1366,181,20893,2552,2424,7081,4354,1028,2412,1042,15917,3454
0500000US48191,Hall County  Texas,276,49,163,60,4,2084,248,255,600,574,108,204,95,1581,299
0500000US48193,Hamilton County  Texas,637,123,381,127,6,5925,434,661,2000,1105,437,903,385,4830,1288
0500000US48195,Hansford County  Texas,537,116,244,118,59,3377,613,439,942,777,122,349,135,2325,484
0500000US48197,Hardeman County  Texas,315,121,61,122,11,2722,200,371,952,630,173,282,114,2151,396
0500000US48199,Hardin County  Texas,4594,663,2512,1256,163,37792,1238,3350,14891,9095,3453,4079,1686,33204,5765
0500000US48201,Harris County  Texas,438778,76417,139411,181096,41854,2923369,311908,245169,678269,592818,189478,577860,327867,2366292,905727
0500000US48203,Harrison County  Texas,5838,915,2020,2537,366,43759,2111,4480,15027,10655,3126,5809,2551,37168,8360
0500000US48205,Hartley County  Texas,182,7,65,60,50,4335,322,474,1663,991,141,553,191,3539,744
0500000US48207,Haskell County  Texas,573,201,199,153,20,4118,616,529,1421,797,203,378,174,2973,552
0500000US48209,Hays County  Texas,35068,2448,8676,21356,2588,121585,5642,7131,27163,28696,7435,29871,15647,108812,45518
0500000US48211,Hemphill County  Texas,319,80,62,171,6,2440,260,241,715,589,122,397,116,1939,513
0500000US48213,Henderson County  Texas,6401,1327,2703,2156,215,56575,3543,5774,19091,14081,3780,6846,3460,47258,10306
0500000US48215,Hidalgo County  Texas,93716,18240,28307,41489,5680,473253,103740,64291,109847,86046,22457,61689,25183,305222,86872
0500000US48217,Hill County  Texas,2954,434,997,1437,86,24146,1637,2620,8357,5369,2031,2853,1279,19889,4132
0500000US48219,Hockley County  Texas,2717,413,944,1215,145,14354,1717,1730,3818,3487,1595,1382,625,10907,2007
0500000US48221,Hood County  Texas,3891,432,1568,1644,247,41014,1817,2540,12296,11032,2631,7135,3563,36657,10698
0500000US48223,Hopkins County  Texas,2887,460,1168,1128,131,24295,1713,2243,8800,5615,1475,3033,1416,20339,4449
0500000US48225,Houston County  Texas,1782,388,741,561,92,16692,1021,2274,6157,3665,1215,1779,581,13397,2360
0500000US48227,Howard County  Texas,3685,920,1323,1357,85,24970,2139,3061,8382,6703,1615,2178,892,19770,3070
0500000US48229,Hudspeth County  Texas,378,121,109,148,0,2740,730,533,842,321,126,172,16,1477,188
0500000US48231,Hunt County  Texas,9082,1099,3335,3940,708,60942,3030,6108,21259,14624,4129,7596,4196,51804,11792
0500000US48233,Hutchinson County  Texas,1833,306,709,750,68,14141,507,1545,4728,4165,1249,1378,569,12089,1947
0500000US48235,Irion County  Texas,161,34,51,76,0,1007,32,41,362,327,75,120,50,934,170
0500000US48237,Jack County  Texas,903,340,452,111,0,6073,471,737,2406,1287,406,507,259,4865,766
0500000US48239,Jackson County  Texas,1184,177,471,379,157,9840,686,965,3243,2705,654,1176,411,8189,1587
0500000US48241,Jasper County  Texas,2965,496,1570,881,18,23947,1159,2527,10681,5115,1500,1789,1176,20261,2965
0500000US48243,Jeff Davis County  Texas,104,8,84,0,12,1706,64,190,387,388,79,273,325,1452,598
0500000US48245,Jefferson County  Texas,24930,3322,9054,10802,1752,169331,12401,14657,55151,41050,12912,22559,10601,142273,33160
0500000US48247,Jim Hogg County  Texas,475,153,153,169,0,3148,396,416,1183,621,145,272,115,2336,387
0500000US48249,Jim Wells County  Texas,3848,1257,1122,1361,108,25753,2655,3888,9449,4844,1651,2550,716,19210,3266
0500000US48251,Johnson County  Texas,14106,2373,5872,5235,626,106651,6319,9904,36008,27131,7744,13928,5617,90428,19545
0500000US48253,Jones County  Texas,1679,732,545,355,47,14715,818,2363,5923,3364,558,1328,361,11534,1689
0500000US48255,Karnes County  Texas,1649,544,549,519,37,10480,1188,1310,3840,2017,614,1164,347,7982,1511
0500000US48257,Kaufman County  Texas,9664,1531,3862,3513,758,76279,3949,6601,25276,18463,6191,10351,5448,65729,15799
0500000US48259,Kendall County  Texas,3379,683,1406,1101,189,28749,1074,911,6088,6632,2276,8021,3747,26764,11768
0500000US48261,Kenedy County  Texas,15,0,10,5,0,413,137,137,87,17,7,13,15,139,28
0500000US48263,Kent County  Texas,26,0,16,10,0,556,29,75,182,117,22,69,62,452,131
0500000US48265,Kerr County  Texas,4215,673,1705,1601,236,37151,1731,2548,10207,10463,2706,6161,3335,32872,9496
0500000US48267,Kimble County  Texas,279,75,104,86,14,3240,236,273,1008,858,150,403,312,2731,715
0500000US48269,King County  Texas,8,6,0,0,2,159,8,15,60,39,8,17,12,136,29
0500000US48271,Kinney County  Texas,273,31,83,151,8,2747,369,362,979,655,117,224,41,2016,265
0500000US48273,Kleberg County  Texas,6442,798,1102,3607,935,17263,1560,2038,4350,3961,1067,2997,1290,13665,4287
0500000US48275,Knox County  Texas,335,57,202,76,0,2377,234,230,771,536,139,326,141,1913,467
0500000US48277,Lamar County  Texas,4065,815,1409,1657,184,33676,1682,3519,11329,8550,2680,4199,1717,28475,5916
0500000US48279,Lamb County  Texas,1189,255,296,632,6,8351,1170,997,2720,1666,467,950,381,6184,1331
0500000US48281,Lampasas County  Texas,1492,404,660,393,35,14416,532,830,4052,4043,2078,1933,948,13054,2881
0500000US48283,La Salle County  Texas,729,113,236,334,46,5059,710,896,2150,522,117,464,200,3453,664
0500000US48285,Lavaca County  Texas,1489,222,479,764,24,13732,911,1111,5654,2710,1052,1756,538,11710,2294
0500000US48287,Lee County  Texas,1591,426,517,562,86,11572,843,1022,4253,2840,778,1281,555,9707,1836
0500000US48289,Leon County  Texas,1170,235,395,507,33,12025,733,1384,4664,2371,906,1430,537,9908,1967
0500000US48291,Liberty County  Texas,7428,1439,3063,2619,307,53387,5140,6931,20993,12564,2703,3588,1468,41316,5056
0500000US48293,Limestone County  Texas,2036,508,807,664,57,16099,1315,1725,5611,4154,1034,1609,651,13059,2260
0500000US48295,Lipscomb County  Texas,265,77,68,113,7,2275,177,229,757,467,202,330,113,1869,443
0500000US48297,Live Oak County  Texas,904,345,360,188,11,8787,795,1033,3028,2247,528,744,412,6959,1156
0500000US48299,Llano County  Texas,1058,222,429,350,57,16562,775,1546,4295,4431,1264,3045,1206,14241,4251
0500000US48301,Loving County  Texas,3,0,3,0,0,75,0,17,15,29,14,0,0,58,0
0500000US48303,Lubbock County  Texas,51394,4327,11823,29923,5321,177457,10652,14575,46606,42786,11281,32380,19177,152230,51557
0500000US48305,Lynn County  Texas,461,81,191,146,43,3805,387,522,1126,906,171,524,169,2896,693
0500000US48307,McCulloch County  Texas,517,64,342,92,19,5715,433,706,1741,1511,238,761,325,4576,1086
0500000US48309,McLennan County  Texas,36672,3648,10966,18694,3364,150034,9370,14205,41380,34621,14966,22940,12552,126459,35492
0500000US48311,McMullen County  Texas,24,6,4,13,1,464,14,31,200,96,15,42,66,419,108
0500000US48313,Madison County  Texas,1414,461,638,266,49,9689,856,1083,3754,2220,455,972,349,7750,1321
0500000US48315,Marion County  Texas,663,176,278,160,49,7573,280,970,3083,1647,467,806,320,6323,1126
0500000US48317,Martin County  Texas,570,123,242,168,37,3290,290,465,1023,668,174,477,193,2535,670
0500000US48319,Mason County  Texas,300,46,104,150,0,2976,220,132,974,891,164,427,168,2624,595
0500000US48321,Matagorda County  Texas,3074,482,1289,1226,77,24144,2959,2291,7643,5383,1840,2881,1147,18894,4028
0500000US48323,Maverick County  Texas,6957,1528,2440,2742,247,32606,8602,4543,7141,6130,2109,3019,1062,19461,4081
0500000US48325,Medina County  Texas,4853,1095,1720,1830,208,32962,2480,3121,10189,8125,2520,4237,2290,27361,6527
0500000US48327,Menard County  Texas,103,4,81,7,11,1716,194,121,603,403,90,175,130,1401,305
0500000US48329,Midland County  Texas,15450,2722,6038,5647,1043,102481,6571,9991,26517,23129,8224,20081,7968,85919,28049
0500000US48331,Milam County  Texas,2048,451,862,598,137,16546,1118,1824,6320,3565,1434,1695,590,13604,2285
0500000US48333,Mills County  Texas,401,124,110,166,1,3411,413,253,1038,785,302,448,172,2745,620
0500000US48335,Mitchell County  Texas,1140,479,414,201,46,5769,517,708,2152,1305,406,566,115,4544,681
0500000US48337,Montague County  Texas,1421,321,467,570,63,13546,732,1234,5083,3388,1013,1359,737,11580,2096
0500000US48339,Montgomery County  Texas,46032,9446,14537,17947,4102,360769,19088,26509,80427,82672,27019,82710,42344,315172,125054
0500000US48341,Moore County  Texas,2369,706,756,787,120,12516,2833,1338,2916,2699,938,1208,584,8345,1792
0500000US48343,Morris County  Texas,910,218,373,319,0,8673,372,637,3536,2446,340,856,486,7664,1342
0500000US48345,Motley County  Texas,55,15,19,21,0,791,19,90,238,262,50,109,23,682,132
0500000US48347,Nacogdoches County  Texas,12741,674,2659,8683,725,37475,2544,3730,10944,8511,2569,5784,3393,31201,9177
0500000US48349,Navarro County  Texas,4150,584,1849,1605,112,31679,3279,3600,9315,7487,2884,3270,1844,24800,5114
0500000US48351,Newton County  Texas,1470,652,556,262,0,9708,530,1052,4050,2660,555,686,175,8126,861
0500000US48353,Nolan County  Texas,1461,459,434,485,83,9613,817,1004,3178,2368,759,1101,386,7792,1487
0500000US48355,Nueces County  Texas,36443,4968,13345,15669,2461,234039,17789,23425,67576,56141,18705,32467,17936,192825,50403
0500000US48357,Ochiltree County  Texas,903,254,168,453,28,6174,774,753,1940,1349,422,730,206,4647,936
0500000US48359,Oldham County  Texas,176,79,73,23,1,1150,45,120,384,251,91,196,63,985,259
0500000US48361,Orange County  Texas,7124,1358,2549,3005,212,56063,1586,4980,21728,14211,5002,6604,1952,49497,8556
0500000US48363,Palo Pinto County  Texas,2330,527,1161,516,126,19305,1163,1936,6953,4780,1286,2263,924,16206,3187
0500000US48365,Panola County  Texas,2081,324,666,1046,45,15785,822,1758,5285,4407,1069,1661,783,13205,2444
0500000US48367,Parker County  Texas,10527,1567,4121,3917,922,87084,3573,5962,25111,21585,7551,16074,7228,77549,23302
0500000US48369,Parmer County  Texas,926,291,358,248,29,6048,1162,606,1893,1068,250,831,238,4280,1069
0500000US48371,Pecos County  Texas,1356,399,532,352,73,10580,1826,1399,3858,2039,426,624,408,7355,1032
0500000US48373,Polk County  Texas,3699,750,1508,1237,204,34334,2290,4510,12601,7917,2217,3520,1279,27534,4799
0500000US48375,Potter County  Texas,11227,2094,4055,4503,575,76310,8012,9212,24126,18102,5568,7736,3554,59086,11290
0500000US48377,Presidio County  Texas,584,388,143,44,9,4602,1821,370,881,510,97,609,314,2411,923
0500000US48379,Rains County  Texas,697,162,316,214,5,8473,525,764,3545,2107,539,667,326,7184,993
0500000US48381,Randall County  Texas,13576,1605,3836,7239,896,86951,2007,5065,19061,24416,8569,18962,8871,79879,27833
0500000US48383,Reagan County  Texas,357,29,253,75,0,2283,224,238,878,618,83,174,68,1821,242
0500000US48385,Real County  Texas,265,22,138,99,6,2440,198,176,687,686,190,357,146,2066,503
0500000US48387,Red River County  Texas,1008,152,508,318,30,8804,475,894,3539,2152,637,851,256,7435,1107
0500000US48389,Reeves County  Texas,1682,340,761,562,19,10073,1854,1786,2779,2073,495,787,299,6433,1086
0500000US48391,Refugio County  Texas,637,179,163,295,0,4900,398,549,1799,1101,475,415,163,3953,578
0500000US48393,Roberts County  Texas,41,9,28,1,3,567,5,46,157,162,48,112,37,516,149
0500000US48395,Robertson County  Texas,1426,309,615,502,0,11401,711,1132,4179,3027,513,1294,545,9558,1839
0500000US48397,Rockwall County  Texas,7353,977,2466,3249,661,60582,2171,2590,11864,14306,5248,15909,8494,55821,24403
0500000US48399,Runnels County  Texas,857,179,332,299,47,6968,776,721,2435,1367,395,1034,240,5471,1274
0500000US48401,Rusk County  Texas,4770,1064,1807,1802,97,36574,2724,4536,11522,9436,3046,3602,1708,29314,5310
0500000US48403,Sabine County  Texas,500,127,173,189,11,7994,301,796,3117,2057,447,783,493,6897,1276
0500000US48405,San Augustine County  Texas,535,119,137,279,0,6124,458,717,2390,1386,357,489,327,4949,816
0500000US48407,San Jacinto County  Texas,1918,692,878,292,56,19779,1262,1916,9787,3831,823,1422,738,16601,2160
0500000US48409,San Patricio County  Texas,6112,1107,2854,1966,185,42736,3781,4960,13974,10523,3130,4364,2004,33995,6368
0500000US48411,San Saba County  Texas,505,123,261,98,23,4239,540,552,1433,964,140,451,159,3147,610
0500000US48413,Schleicher County  Texas,218,24,81,39,74,2001,267,163,481,629,131,257,73,1571,330
0500000US48415,Scurry County  Texas,1698,441,700,515,42,11238,1171,1320,3629,2674,587,1177,680,8747,1857
0500000US48417,Shackelford County  Texas,282,122,91,69,0,2245,129,217,507,734,98,385,175,1899,560
0500000US48419,Shelby County  Texas,2312,594,899,769,50,16320,1755,2317,5444,3572,866,1783,583,12248,2366
0500000US48421,Sherman County  Texas,256,79,90,78,9,2092,331,160,581,528,79,320,93,1601,413
0500000US48423,Smith County  Texas,22778,3473,6293,11418,1594,146551,9181,12475,35529,37927,13590,25489,12360,124895,37849
0500000US48425,Somervell County  Texas,756,135,292,266,63,5972,128,599,2060,1429,326,1074,356,5245,1430
0500000US48427,Starr County  Texas,7370,1760,2677,2499,434,35345,10404,6744,8830,4468,1241,2569,1089,18197,3658
0500000US48429,Stephens County  Texas,841,319,314,181,27,6422,421,1052,1916,1524,441,712,356,4949,1068
0500000US48431,Sterling County  Texas,32,0,15,17,0,782,52,58,359,160,29,71,53,672,124
0500000US48433,Stonewall County  Texas,88,37,40,0,11,989,32,73,431,285,33,96,39,884,135
0500000US48435,Sutton County  Texas,252,17,116,119,0,2659,402,256,796,576,159,372,98,2001,470
0500000US48437,Swisher County  Texas,525,122,198,190,15,5059,495,860,1605,1190,262,482,165,3704,647
0500000US48439,Tarrant County  Texas,189330,27096,62898,80565,18771,1290366,87353,98243,309229,291433,98132,271552,134424,1104770,405976
0500000US48441,Taylor County  Texas,19610,1880,6458,9626,1646,83059,4012,5657,25030,21282,6712,13445,6921,73390,20366
0500000US48443,Terrell County  Texas,32,0,0,32,0,717,92,41,208,258,8,68,42,584,110
0500000US48445,Terry County  Texas,1126,315,530,269,12,8029,1422,1114,2541,1724,265,664,299,5493,963
0500000US48447,Throckmorton County  Texas,133,8,66,53,6,1126,75,91,415,261,70,165,49,960,214
0500000US48449,Titus County  Texas,3312,664,1417,1187,44,19884,2577,2241,6500,3967,1439,2322,838,15066,3160
0500000US48451,Tom Green County  Texas,14453,1163,4940,7292,1058,75126,4538,6230,22881,17842,5473,12479,5683,64358,18162
0500000US48453,Travis County  Texas,114109,12372,27259,56110,18368,819773,48185,41113,137546,148677,45923,252655,145674,730475,398329
0500000US48455,Trinity County  Texas,939,178,435,295,31,10680,645,1127,4005,2734,804,1005,360,8908,1365
0500000US48457,Tyler County  Texas,2296,810,967,421,98,15121,575,1786,6681,3549,641,1406,483,12760,1889
0500000US48459,Upshur County  Texas,3314,579,1439,1143,153,27588,1468,2853,9400,6949,2223,3316,1379,23267,4695
0500000US48461,Upton County  Texas,267,50,132,75,10,2311,263,240,927,555,98,146,82,1808,228
0500000US48463,Uvalde County  Texas,2811,557,1137,945,172,16824,2501,2150,4519,3476,1528,1973,677,12173,2650
0500000US48465,Val Verde County  Texas,5563,1127,1908,1889,639,29364,5976,3356,6981,5826,1765,3768,1692,20032,5460
0500000US48467,Van Zandt County  Texas,4132,961,1742,1261,168,37568,2212,3969,12502,9331,3141,4693,1720,31387,6413
0500000US48469,Victoria County  Texas,8573,1557,3220,3399,397,59826,4225,5820,18165,14382,5209,8301,3724,49781,12025
0500000US48471,Walker County  Texas,14449,806,2421,10259,963,46214,2965,3899,17830,9569,2416,6674,2861,39350,9535
0500000US48473,Waller County  Texas,10197,789,3199,6022,187,27604,2636,2656,8945,6348,1533,3749,1737,22312,5486
0500000US48475,Ward County  Texas,1162,311,578,203,70,7234,828,710,2549,1884,279,695,289,5696,984
0500000US48477,Washington County  Texas,3896,474,1191,2114,117,23187,1461,1841,7554,4957,1584,3767,2023,19885,5790
0500000US48479,Webb County  Texas,31165,5846,11999,12076,1244,149553,27935,21000,39427,24035,9607,19504,8045,100618,27549
0500000US48481,Wharton County  Texas,3811,955,1143,1525,188,26922,2838,2991,7955,6374,2159,2884,1721,21093,4605
0500000US48483,Wheeler County  Texas,346,40,162,138,6,3712,263,431,1109,976,317,473,143,3018,616
0500000US48485,Wichita County  Texas,17864,1322,8091,7561,890,84203,4308,7074,26643,19979,6835,13226,6138,72821,19364
0500000US48487,Wilbarger County  Texas,1073,185,380,471,37,8922,846,1068,3004,1921,646,1105,332,7008,1437
0500000US48489,Willacy County  Texas,2852,669,1211,972,0,13600,2899,1738,4964,2103,525,1035,336,8963,1371
0500000US48491,Williamson County  Texas,41628,5724,13426,18041,4437,346522,10851,12584,70838,79994,29687,94573,47995,323087,142568
0500000US48493,Wilson County  Texas,3980,514,1500,1744,222,32427,1945,2410,11631,7338,2450,4342,2311,28072,6653
0500000US48495,Winkler County  Texas,894,250,295,314,35,4547,802,698,1268,1083,263,306,127,3047,433
0500000US48497,Wise County  Texas,5253,822,2537,1701,193,43243,2427,4028,14612,11160,3469,5650,1897,36788,7547
0500000US48499,Wood County  Texas,3352,628,1099,1537,88,31947,1813,3039,10919,8727,2203,3715,1531,27095,5246
0500000US48501,Yoakum County  Texas,734,134,239,287,74,5010,1040,555,1445,800,353,598,219,3415,817
0500000US48503,Young County  Texas,1287,257,498,421,111,12441,594,1425,4371,3142,471,1719,719,10422,2438
0500000US48505,Zapata County  Texas,1475,374,648,453,0,8059,2069,1157,2378,1282,338,591,244,4833,835
0500000US48507,Zavala County  Texas,1399,192,450,637,120,7149,1418,1301,2240,1181,395,401,213,4430,614
